
F 34,139,34

C 30,144,5

NO img/testmc/N.xpm
SO img/testmc/S.xpm
EA img/testmc/E.xpm
WE img/testmc/W.xpm

11111111111111111111111111111111111111111
1S000000000000000000000000000000000000001
1000000000000000000D000000100000000000001
10000000000000000000000000000000001000001
10000000000000000000000000100000000000001
11111111D11111100000000000000000001000001
10000000000000D00000000000100000000000001
10000000000000100000000000000000001000001
11111111111111D00000000000100000000000001
10000000000000000000000000000000001000001
10000000000000000000000000100000000000001
10000000000000000000000000000000001000001
10000000000000000000000000100000000000001
11111111111111000000000000000000001000001
1000000000001100000000000011111D111000001
1000000000000D000000000000100000001000001
10000000000111000000000000100000001000001
11111111111111111111111111111111111111111
