F 34,139,34

C 3,144,5

NO img/testmc/1.xpm
SO img/testmc/0.xpm
EA img/testmc/E.xpm
WE img/testmc/E2.xpm


1111111111111
1000001000001
1000001000001
1000001000001
100000C000001
1000001000001
1000001000001
1000001000001
1111111111111