F 34,139,5

C 30,144,255

NO img/new/N.xpm
SO img/new/S.xpm
EA img/new/E.xpm
WE img/new/W.xpm

11101111111
10000000001
100N0000001
11111111111
