F 34,139,34

C 3,144,5

NO img/testmc/1.xpm
SO img/testmc/0.xpm
EA img/testmc/E.xpm
WE img/testmc/E2.xpm


111111111111
100000100000
100000100000
100000100000
100000100000
100000100000
100000100000
100000100000
111111111111