
F 34,139,34

C 30,144,0

NO img/new/N.xpm
SO img/new/S.xpm
EA img/new/E.xpm
WE img/new/W.xpm
WE img/new/W.xpm

1111111111111111111111111111111111111111111111
1000000000000000000000110001000000101000000001
1000111111111100000000110001000011101000000001
1000000000000100000000110001000000101000000001
1000111111110100000000110001111111101000000001
1000000000010100000000110000000000101000000001
1000000000000000000000000000000000000000000001
1000000011100111111011110000000111001111110111
1000000000000000000000110000000000000000000001
1000001111111111111011110000011111111111110111
1000111111110100000000110001111111101000000001
1000000000010100000000110000000000101000000001
1000000011100111111010110000000111001111110111
1000001100000000000000010000011000000000000001
1000001110111111111011010000011101111111110111
1000000000000000000001011000000000000000000001
1000000000000000000001011000000000000000000001
1000000000000000000001011000000000000000000001
1000000000000000000001010000000000000000000001
1000000000000000000001010000000000000000000001
1000000000000000000001010000000000000000000001
1000000000000000000001010000000000000000000001
100N000000000000000000010000000000000000000001
1000000000000000000000000000000000000000000001
1000000000000000000000110000000000000000000001
1000000000000000000000000000000000000000000001
1000000000000000000000110000000000000000000001
1000000000000000000000000000000000000000000001
1000000000000000000000110000000000000000000001
1000000000000000000000000000000000000000000001
1000000000000000000000110000000000000000000001
1000000000000000000000000000000000000000000001
1000000000000000000000110000000000000000000001
1000000000000000000000000000000000000000000001
1000000000000000000000110000000000000000000001
1000000000000000000000000000000000000000000001
1000000000000000000000110000000000000000000001
1111111111111111111111111111111111111111111111