NO img/new/N.xpm
SO img/new/S.xpm
EA img/new/E.xpm
WE img/new/W.xpm


F 255,0,255
C 11,38,75

1111111111111111111111111111111111111111111111111111111111111111111111111111111
1000000000000000000000000000000000000000000000000000000000000000000000000000001
1000000000000000000000000000000000000000000000000000000000000000000000000000001
1000000000000000000000000000000000000000001111111000000000000000000000000000001
10000000000000N000000000000000000000000001      1000000000000000000000000000001
10000000000000000000000000000000000000001       1000000000000000000000000000001
1000000000000000000000000000000000000001        1000000000000000000000000000001
100000000000000000000000000000000000001         1000000000000000000000000000001
10000000000000000000000000000000000001          1111111111111111111111111111111
1000000010000000000000000000000000001
10000001 100000000000000000000000001
10000010  1000000000000000000000001
1000001   100000000000000000000001
1000001   10000000000000000000001
10000001 10000000000000000000001
1000000010000000000000000000001
1111111111111111111111111111111
