
F 34,139,34

C 30,144,255

NO img/new/N.xpm
SO img/new/S.xpm
EA img/new/E.xpm
WE img/new/W.xpm

111111111111111111111111111
100000000000000000000000001
100000000000000000000000001
100N00000000000000000000001
111111111111111111111111111
