
F 34,139,34

C 30,144,255

NO img/feuille/north_wall.xpm
SO img/feuille/south_wall.xpm
EA img/feuille/east_wall.xpm
WE img/feuille/west_wall.xpm

11111111111111111111111
10000000000000000000001
10001111111111000000001
10000000000001000000001
10001111111101000000001
10000000000101000000001
10000000111001111110111
10000011000000000000001
100000111D1111111110111
10000000N00000000000001
11111111111111111111111
