
F 34,139,34

C 30,144,255

NO img/testmc/N.xpm
SO img/testmc/S.xpm
EA img/testmc/E.xpm
WE img/testmc/W.xpm

11111111111
10000000001
10000000001
10000000001
10000000001
10000000001
10000000001
10000000001
10000000001
10000000001
10000000001
10000000001
10000000001
10000000001
100N0000001
11111111111
