

F 255,165,0

C 255,99,80

NO img/brique/north_wall.xpm
SO img/brique/south_wall.xpm
EA img/brique/east_wall.xpm
WE img/brique/west_wall.xpm


111111111111111111111111
100000000000000000000001
100000000000000000000001
100000000000000000000001
100000000001111000000001
100000000000000000000001
100000000000000111111111
1000000000000001
100000000000000111111111
100000111111111111111111
100N00000000000000000001
100000110111111111101001
100000110000000000000001
111111111111111111111111