

NO img/testmc/N.xpm
SO img/testmc/S.xpm
EA img/testmc/E.xpm
WE img/testmc/W.xpm

F 34,139,34

C 30,144,5

11111111111111111111111111111111111111111
1E000000000000000000000000000000000000001
10000000000000000000000000000000000000001
10000000000000000000000000000000000000001
10000000000000000000000000000000000000001
10011111111111100000000000000000000000001
10000000000010100000000000000000000000001
10000000000000000000000000000000000000001
10000000000111100000000000000000000000001
10000000000000000000000000000000000000001
10000000000000000000000000000000000000001
10000000000000000000000000000000000000001
10000000000000000000000000000000000000001
11111111111111000000000000000000001000001
10000000000010100000000000000000000000001
10000000000000000000000000000000000000001
10000000000111100000000000000000000000001
11111111111111111111111111111111111111111