
F 34,139,34

C 30,144,255

NO img/new/N.xpm
SO img/new/S.xpm
EA img/new/E.xpm
WE img/new/W.xpm

11111111111111111111111
10000000000000000000001
10001111111111000000001
10000000000001000000001
10001111111101000000001
10000000000101000000001
10000000111001111110111
10000000000000000000001
10000011111111111110111
10001111111101000000001
10000000000101000000001
10000000111001111110111
10000011000000000000001
10000011101111111110111
10000000000000000000001
10000000000000000000001
10000000000000000000001
10000000000000000000001
10000000000000000000001
100N0000000000000000001
10000000000000000000001
11111111111111111111111
